10x10
@@@@@@@@@@
@---@--E-@
@-E-@----@
@---@@@--@
@--------@
@--------@
@@@@@@@--@
@--------@
@P-------@
@@@@@@@@@@